A	AH
A(2)	EY
AM	AE M
AM(2)	EY EH M
COVID	K OW V AH D
DO	D UW
GO	G OW
HELP.	HH EH L P
HOSPITAL.	HH AA S P IH T AH L
HOW	HH AW
I	AY
I.	AY
LIKE	L AY K
LOST.	L AO S T
MY	M AY
NAVIGATE	N AE V AH G EY T
ROOM.	R UW M
SURVEY.	S ER V EY
TAKE	T EY K
THE	DH AH
THE(2)	DH IY
TO	T UW
TO(2)	T IH
TO(3)	T AH
WHERE	W EH R
WHERE(2)	HH W EH R
WOULD	W UH D